111111111111111111111111111111111111111111
1C00000000000000000000000000000000000001E1
1110000000000000C00000000000000000000001F1
1000000000B0000000000000000000000000000001
101000000000000000000B00000010000000000001
1C1000000000000000000000000010000000000001
10100000000000000000000000001000CC000CC001
10100000000000C0000000000000100C000C000C01
1011F100011110000111100000001000C00B00C001
101CC10001CC100001CCF0000000F0000C000C0001
1011110001F11000011110000000100000C0C00001
1P000000000000C00000000000001000000C000001
111111111111111111111111111111111111111111
