11111111111111
1000000001C101
100C00000101E1
10C00C00000001
1P000010000001
100000B0000001
11111111111111
