1111111111111111111111111111111111
1P00000000000000000000000000000001
1011111111111111111111111111111101
1000000000000000000000000000000001
1011111111111111111111111111111101
1000000000000000000000000000000001
1011111111111111111111111111111101
100000000000000B0B0000000000000001
1011111111111111111111111111111101
100000000000000B0B0000000000000001
1011111111111111111111111111111101
1000000000000000000000000000000001
1011111111111111111111111111111101
1T000000C00000000000000000000000E1
1111111111111111111111111111111111