1111111111111111111111111111111111
1P00000000000000000000000000000001
101111FF1111111FF11111111111111101
1000CCCCCCCCCCCCCCCCCCCCCCCCCC0001
10F0B000000000000000000000000B0F01
10F0B0F1111111111FF111111F0B0F0FF1
10F0B0F1CCCCCCCCCCCCCCCC1F0B0F0FF1
10F0B0F100000000000000001F0B0F0FF1
10F0B0F1111111T11FF11111F0B0F0FFF1
10F0B000000000000000000000B0F0FFF1
10F0B000000000000000000000B0F0FFF1
10F0B0F111FF11111FF111111F0B0F0FF1
10F0B0F1CCCCCCCCCCCCCCCC1F0B0F0FF1
10F0B0F100000T00000000001F0B0F0FF1
10F0B0F111FF11E111111111F0B0F0FFF1
10T0CCCCCCCCCCCTCCCCCCCCCCCCCC0001
1111111111111111111111111111111111