1111111111111111111111111111111111111111
1P00000000000000000000000000000000000001
1011111111111111111111111111111111111101
1010000C0000C0000C0000C0000C0000C0000001
1F1F1F1F1F1F1F1F1F1F1F1F1F1F1F1F1F1F0FF1
10000000000000000B0000000000000000000T01
1011111111111111111111111111111111111101
10C0000C0000C0000C0000C0000C0000C0000F01
1F1F1F1F1F1F1F1F1F1F1F1F1F1F1F1F1F1FFFF1
10000000000B0000000000000000000000000001
1011111111111111111111111111111111111101
10T0000C0000C0000C0000C0000C0000C0000FE1
1111111111111111111111111111111111111111