111111111111111111111111111
1PC000000000000000000000001
111111111111111111111111101
100000000000000000000000F01
10111111111111F111111110101
101000000000000000000010101
10101111111F111111111010101
10101000000B000000001010101
101010111111111F11101010101
101010100000000000101010101
101010101111111110101010101
101010101000000010101010101
101010101011111010101010101
1010101010F00T1010101010101
101010101011111010101010101
101010101000000000101010101
101010101111111111101010101
101010100000000000001010101
101010111111F111111F1010101
101010000000B00000000010101
101011111111111111111110101
101000000000000000000000101
101111111111F11111111111101
1000000000000B0000000000001
1111111111FF11111111111FF11
1TCCCCCCCCCCCCCCCCCCCCCCCE1
111111111111111111111111111